             /\               
            <  >              
             \/               
             /\               
            /  \              
           /++++\             
          /  ()  \            
          /      \            
         /~`~`~`~`\           
        /  ()  ()  \          
        /          \          
       /*&*&*&*&*&*&\         
      /  ()  ()  ()  \        
      /              \        
     /++++++++++++++++\       
    /  ()  ()  ()  ()  \      
    /                  \      
   /~`~`~`~`~`~`~`~`~`~`\     
  /  ()  ()  ()  ()  ()  \    
  /*&*&*&*&*&*&*&*&*&*&*&\    
 /                        \   
/,.,.,.,.,.,.,.,.,.,.,.,.,.\  
           |   |              
          |`````|             
          \_____/             
